NO ./textures/cyan.png
SO ./textures/pink.png
WE ./textures/yellow.png
EA ./textures/black.png

F 47,53,66
C 236,204,104

11111111111
11000000011
10000W00001
11000100011
11111111111