NO ./textures/north.png
SO ./textures/south.png
WE ./textures/west.png
EA ./textures/east.png

F 47,53,66
C 236,204,104

11111111111
11000000011
10000S00001
11000100011
11111111111
