NO ./textures/1.png
SO ./textures/5.png
WE ./textures/8.png
EA ./textures/15.png

F 25,25,25
C 50,50,50

11111111111111111111
10000000000000000001
11111110011100000001
1000001001010000W001
11111110011100000001
10000000000000000001
11111111111111111111